EBBBBBBBBBBBBBBBBBBBBBBBBBBBBBBBBBBBBB
FPPPPPPPPPPPPPPPPPPPPPPPPPPPPPPPPPPPPP
FDDDDDDDDDDDDDDDDDDDDDDDDDDDDDDDDDDDDD
FGSCGSCGSCGSCGSCGSCGSCGSCGSCGSCGSCGSCG
FGSCGSGCGSCGSGCGSCGSGCGSCGSCGSGCGSGCGS
HCGSCGSCGSGCGSCGSGCSGCGSCGSGCGSGCGGCGS
PGSGCGSCGGSCGSGCSGCGSCGSGCGSCGSGCGSCGG
DGSGCGSGCSCSCGSGGSCCGCGGSCCSSCGGCSGCSC
CCSSCGGSCCSGGSSCGSCGCSCCCSGGSGSGCGSCSC
IGSCGSGCGSCGSGCGSCGSGCGSCGSCGSGCGSGCGS
FCGSCGSCGSGCGSCGSGCSGCGSCGSGCGSGCGGCGS
FGSGCGSCGGSCGSGCSGCGSCGSGCGSCGSGCGSCGG
FCGSGCGSGCSCSCGSGGSCCGCGGSCCSSCGGCSGCS
FCSSCGGSCCSGGSSCGSCGCSCCCSGGSGSGCGSCSC
KJJJJJJJJJJJJJJJJJJJJJJJJJJJJJJJJJJJJJ
